1111111111111
10011000000C1
1000011111001
1P0011E100001
1111111111111