1111111111111
10C10000000C1
10000111B1001
1P0011E000001
1111111111111